0, 0, 0, 0, 0, 0, 0, 0, 0, 0
0, 3, 0, 0, 0, 0, 0, 0, 0, 0
0, 2, 9, 0, 0, 0, 0, 0, 0, 0
0, 0, 2, 3, 3, 2, 0, 0, 0, 0
0, 0, 0, 9, 9, 0, 0, 0, 0, 0
0, 0, 2, 0, 1, 3, 0, 0, 0, 0
0, 0, 0, 0, 0, 0, 0, 0, 0, 0
0, 0, 0, 0, 0, 0, 0, 0, 0, 0
0, 0, 0, 0, 0, 0, 0, 0, 0, 0
0, 0, 0, 0, 0, 0, 0, 0, 0, 0